|Map|
version=1~
tilesheet=assets\tilesheets\overworld_tiles.png~
name=Level 2~
mapWidth=24~
mapHeight=16~
tileWidth=16~
tileHeight=16~
scaleX=2~
scaleY= 2~
dataLength=384~
data=
	 10,	 10,	 10,	 10,	 10,	 10,	 10,	 10,	 10,	 10,	 10,	 10,	 10,	 10,	 10,	 10,	 10,	 10,	 10,	 10,	 10,	 10,	 10,	 10,
	 10,	 15,	 31,	 31,	 31,	 16,	 10,	 10,	 10,	 10,	 10,	 10,	 10,	 10,	 10,	 10,	 10,	 10,	 10,	 10,	 10,	 10,	 10,	 10,
	 10,	 26,	 11,	 11,	 11,	 24,	 15,	 16,	 10,	 10,	 10,	 10,	 10,	 10,	 10,	 10,	 10,	 10,	 10,	 10,	 10,	 10,	 10,	 10,
	 10,	 21,	 19,	 19,	 19,	 22,	 26,	 24,	 10,	 10,	 10,	  0,	  1,	  1,	  1,	  1,	  1,	  2,	 10,	 10,	 10,	 10,	 10,	 10,
	 10,	 27,	 11,	 11,	 11,	 28,	 21,	 22,	 10,	 10,	 10,	  6,	  7,	  9,	  7,	  3,	  7,	  8,	 10,	 10,	 10,	 10,	 10,	 10,
	 10,	 27,	 11,	 11,	 11,	 11,	 11,	 28,	 10,	 10,	 10,	  6,	  9,	  7,	  7,	  9,	  7,	  8,	 10,	 10,	 10,	 10,	 10,	 10,
	 10,	 27,	 11,	 11,	  4,	 11,	 11,	 34,	 10,	 10,	 10,	  6,	  7,	  3,	  7,	  7,	  7,	  8,	 10,	 10,	 10,	 10,	 10,	 10,
	 10,	 10,	 10,	 10,	 10,	 10,	 10,	 10,	 10,	 10,	 10,	  6,	  7,	  7,	  9,	  7,	  9,	  8,	 10,	 10,	 10,	 10,	 10,	 10,
	  0,	  1,	  1,	  1,	  1,	  1,	  1,	  1,	  2,	 10,	 10,	  6,	  7,	  9,	  7,	  7,	  3,	  8,	 10,	 15,	 31,	 16,	 10,	 10,
	  6,	  9,	  3,	  7,	  7,	  9,	  7,	  7,	  8,	 10,	 10,	 12,	  9,	 13,	 13,	 13,	 13,	 14,	 10,	 21,	 19,	 22,	 10,	 10,
	  6,	  7,	  9,	  9,	  7,	  3,	  9,	  7,	  8,	 10,	 10,	 10,	 10,	 10,	 10,	 10,	 10,	 10,	 10,	 27,	  5,	 28,	 10,	 10,
	 12,	 13,	 13,	 13,	 13,	 13,	 13,	 13,	 14,	 10,	 10,	 10,	 10,	 10,	 10,	 10,	 10,	 10,	 10,	 27,	 11,	 28,	 10,	 10,
	 10,	 10,	 10,	 10,	 10,	 10,	 10,	 10,	 10,	 10,	 10,	 10,	 10,	 10,	 10,	 10,	 10,	 10,	 10,	 27,	 11,	 28,	 10,	 10,
	 10,	 10,	 10,	 10,	 10,	 10,	 10,	 10,	 10,	 10,	 10,	 10,	 10,	 10,	 10,	 10,	 10,	 10,	 10,	 33,	 11,	 34,	 10,	 10,
	 10,	 10,	 10,	 10,	 10,	 10,	 10,	 10,	 10,	 10,	 10,	 10,	 10,	 10,	 10,	 10,	 10,	 10,	 10,	 10,	 10,	 10,	 10,	 10,
	 10,	 10,	 10,	 10,	 10,	 10,	 10,	 10,	 10,	 10,	 10,	 10,	 10,	 10,	 10,	 10,	 10,	 10,	 10,	 10,	 10,	 10,	 10,	10~
|~Map|
